...###...#
.###....##
..........
..#...##..
...#@.....
..........
...####...
.......###
####....##
##.....###