##..##..##
#....#....
###.....##
####....#.
..###.@.#.
..##...#..
.#.....##.
..........
...####...
..###...##