.....#####
..###..##.
....##...#
..####..##
.....@..##
..###....#
...##..#..
.##.....##
.......##.
.....###..